-----------------------------------------------------
|   HEADER                                          |
-----------------------------------------------------
| Config. Avançadas       |   Playlists             |
-----------------------------------------------------
|                         |  Videos da playlist     |
|    VIDEOS DRAFT         |-------------------------|
|                         | Videos Selecionados     |
----------------------------------------------------|

